11111111111111111111111111111111111111111111111111
10000001000000001000001000000010000000000010000001
10000901030000201020001080000010000000000010000401
10000001000000001000001000000010000000000010000001
10001111111000111110001111100000001111100010001111
10000000000000000000001000105000001000000000000001
10000000000000000000001000100000001000003000000001
10000000000000000000001000111110001000000000000001
11111000111111111000111000100000001000100011110001
10001000000100010000001000100000501000100010000001
10401000040104010000001000100000001000100010200001
10001000000100010000001000111111111000100010000001
10000000000100000000001000000000000000100000000001
10000000000100000000301000000000000000100000004001
10000000000100000000001000000000000000100000000001
11111111111111111111111111111111111111111111111111
10000000001000000010000000000010001000000000000011
10400000001000008010000000000010401020000000003011
10000000001000000010000000000010001000000000000011
11111110001000111110000000000010001111110001111111
10000010000000100010000000000000000000000000000011
10300010000000100010000060000000000000000000000011
10000010000000100010000000000000000000000000000011
10001110001111100010000000000011111000111111100011
10001000001000100010000000000010001000100000105011
10001000001030100010000000000010501000100000100011
10001000001000100010000000000010000000100800111111
10001000111000100011111000111110000000100000100011
10000000001000000010000000000010000000100000100011
10000000001000000010000000000011111000110001100011
10000000001000000010000000000010000000100000000011
11111110001000111111111000111110000000100000000011
10000000001000000010000000000010000000100000000011
10000000001000000010000000000010001111111111100011
10000000001000000010000000000010001000000000100011
10001000111111100010001000100010001000000000100011
10001000000000000010001000100010001000000000100011
10001000000000002010001070100010000001000100000011
10501000000000000010201000104010200001040100005011
10001111111111111110001000100010000001000100000011
11111111111111111111111111111111111111111111111111