11111111111111111111111111111111111111111111111111
10000000000000000000000000100000001000000100010001
10700000000000000000000000100000001030000105010501
10000000000000000000000000100000001000000100010001
10001000111111110001111000100011111111000100010001
10001000000000010000001000000010000000000000010001
10001000000000010000201000000010000000000000010001
10001000000000010000001000000010000000000000010001
11111111111100011111111111100010001111000111110001
10000000100000000000000000100000001000000100000001
10000000104000000000000000100000001000000104000001
10000000100000000000000000100000001000000100000001
11111000111100011111000111111111111111000111110001
10001000000000010001000100010000000001000000010001
10201000000000010801050100010000000001000002010001
10001000000000010001000100010000000001000000010001
10000000100011110001111100010050010001000100000001
10000000100010000000000000010000010001000100000001
10000000100010000000000000010000010001000100000001
11111111100010000000000000011111110001000111111111
10000000000010000001000100000000000000000000000001
10000000000010500001000100000000000000000000000001
10000000000010000001000100000000000000000000000001
10001111100011111111000111110001000100011111110001
10001000000000000000000000010001000100000000010001
10001000000000000000000000010001020100000004010001
10001000000000000000000000010001000100000000010001
10001000100010001111111111110001111100011111110001
10001020100010000000000100000000000000010000000001
10001000100010000000000100000000000000010000000001
10001111100010000000000100000000000000010000000001
10001000000010001111000100011111000100010001111111
10301000000010001001000000010000000100010001000001
10001000000010000001000000010000000100000001009001
11111000111110000001000000010000000100000001000001
10000000000010000001000000010001000100000001000001
10000000004011111111111100010001000111110001110001
10000000000010000000000000000001000000010000000001
11111111111110300000000000000001000004010000000001
10000000000010000000000000000001000000010000000001
11111111111111111111111111111111111111111111111111